../assets/tilesetIso.png 9 64 64
15 15
0 1 2 3 4 5 6 7 8 0 1 2 3 4 5
6 7 8 0 1 2 3 4 5 6 7 8 0 1 2
3 4 5 6 7 8 0 1 2 3 4 5 6 7 8
0 1 2 3 4 5 6 7 8 0 1 2 3 4 5
6 7 8 0 1 2 3 4 5 6 7 8 0 1 2
3 4 5 6 7 8 0 1 2 3 4 5 6 7 8
0 1 2 3 4 5 6 7 8 0 1 2 3 4 5
6 7 8 0 1 2 3 4 5 6 7 8 0 1 2
3 4 5 6 7 8 0 1 2 3 4 5 6 7 8
0 1 2 3 4 5 6 7 8 0 1 2 3 4 5
6 7 8 0 1 2 3 4 5 6 7 8 0 1 2
3 4 5 6 7 8 0 1 2 3 4 5 6 7 8
0 1 2 3 4 5 6 7 8 0 1 2 3 4 5
6 7 8 0 1 2 3 4 5 6 7 8 0 1 2
3 4 5 6 7 8 0 1 2 3 4 5 6 7 8
